Character	Positive Counterpart	Negative Counterpart
Daniel Day-Lewis	Meryl Streep	Captain Ahab
Tina Fey	Joan Rivers	Bill Murray
Abraham Lincoln	Confucius	Dame Edna Everage
John Wilkes Booth	Harry S. Truman	Dorothy Parker
Adam Sandler	Benny Hill	Amy Schumer
Adam Smith	Dame Edna Everage	Boba Fett
Adam West	Chris Rock	Cameron Diaz
The Joker	Hannibal Lecter	Imelda Marcos
Al Bundy	Adam Sandler	Amy Schumer
Al Capone	Ann Coulter	"Wilson ""Kingpin"" Fisk"
Eliot Ness	James Comey	Pippi Longstocking
Al Gore	Ann Coulter	Ned Flanders
Al Pacino	Heath Ledger	Tina Turner
Alan Greenspan	Dame Edna Everage	Adam Smith
Alan Sugar	Charlemagne	Ann Coulter
Albert Einstein	Leonardo Da Vinci	Anna Karenina
Alec Baldwin	Heath Ledger	Ann Coulter
Alfred Hitchcock	Ann Coulter	Al Capone
Allan Quatermain	Buck Rogers	Katharine Hepburn
Andrew Lloyd Webber	John Grisham	Cameron Diaz
Andy Warhol	Alan Sugar	 
Angelina Jolie	Elizabeth Taylor	Al Gore
Ann Coulter	Frank Columbo	Angelina Jolie
Anna Karenina	Angelina Jolie	Charlie Chaplin
Emma Bovary	Alexander the Great	Helen of Troy
Anthony Bourdain	Tina Fey	Adam Sandler
Anton Chekov	Virginia Woolf	Karl Marx
Antonio Vivaldi	Dolly Parton	Muhammad Ali
Archie Bunker	Willie Nelson	Roseanne Barr
Ariel Sharon	Jack Bauer	Gloria Steinem
Aristotle	Saga Norén	Immanuel Kant
Arnold Schwarzenegger	Samson	Sarah Palin
Arthur Conan Doyle	Saga Norén	Elmer Fudd
Atticus Finch	Ophelia	Reginald Jeeves
Audrey Hepburn	Dorian Gray	Taylor Swift
Aung San Suu Kyi	Moses	Angelina Jolie
Austin Powers	Helen Keller	Jar Jar Binks
Ayn Rand	 	 
Babe Ruth	Serena Williams	Homer Simpson
Barack Obama	Cicero	Queen Elizabeth I
Barry White	Giacomo Casanova	Bridget Jones
Bart Simpson	Lizzy Bennet	Basil Fawlty
Basil Fawlty	Tina Fey	Bart Simpson
Bear Grylls	Arya Stark	Daniel Day-Lewis
Ben Affleck	 	 
Benedict Arnold	Professor James Moriarty	Emma Bovary
Benjamin Franklin	David Bowie	Bridget Jones
Benny Hill	Billy Crystal	Bridget Jones
Bertie Wooster	Monsieur Hulot	Phoebe Buffay
Reginald Jeeves	Dexter Morgan	Nurse Ratched
Bill Clinton	Reginald Jeeves	Cleopatra
Bill Cosby	Johnny Carson	Angelina Jolie
Bill Gates	Imelda Marcos	Matt Groening
Bill Murray	Dean Winchester	Tina Fey
Billy Bob Thornton	Meryl Streep	David Lynch
Billy Crystal	Benny Hill	 
Bing Crosby	Dean Martin	Saga Norén
Bob Dylan	Edith Piaf	Al Gore
Leonard Cohen	Dolly Parton	Bob Dylan
Bob Marley	Edith Piaf	Richard Dawkins
Boba Fett	Allan Quatermain	Ayn Rand
Bobby Fischer	Ann Coulter	Brian Wilson
Bono	Karen Carpenter	Noam Chomsky
Brad Pitt	Clark Gable	Bridget Jones
Brian Wilson	Antonio Vivaldi	Lindsay Lohan
Bridget Jones	Silvio Berlusconi	Carrie Bradshaw
Britney Spears	Al Gore	Courtney Love
Bruce Lee	Janet Jackson	Adam West
Bruce Springsteen	Fidel Castro	Angelina Jolie
Bruce Wayne	Imelda Marcos	Eliot Ness
Commissioner James Gordon	Nigella Lawson	Theodore Roosevelt
Harvey Dent	Dian Fossey	Freddy Krueger
Batman	Jason Bourne	Angela Merkel
Catwoman	Batman	Natasha Romanova
Buck Rogers	Amelia Earhart	Buzz Lightyear
Buddha	Dame Edna Everage	Thomas Aquinas
Buzz Aldrin	Virginia Woolf	Alan Sugar
Buzz Lightyear	Han Solo	Diana Ross
Emperor Caligula	Lizzy Bennet	Ming The Merciless
Cameron Diaz	Tyra Banks	Ben Affleck
Captain Ahab	Eliot Ness	 
Cardinal Richelieu	Julius Caesar	Cersei Lannister
Carl Lewis	Trinity	Cristiano Ronaldo
Carl Sagan	Ann Coulter	Confucius
Stephen Jay Gould	Ann Coulter	Al Gore
Carrie Bradshaw	Dorothy Parker	Ryan Reynolds
Enrico Caruso	Dolly Parton	Barry White
Cary Grant	Kevin Spacey	Gwyneth Paltrow
Giacomo Casanova	Ann Coulter	Bill Clinton
Charlemagne	Al Capone	Cleopatra
Charles Atlas	Modesty Blaise	Arnold Schwarzenegger
Charles Darwin	Sigmund Freud	 
Charles Dickens	Arthur Conan Doyle	 
Charles Foster Kane	Lex Luthor	Cleopatra
Charlie Brown	Mahatma Gandhi	Aung San Suu Kyi
Charlie Chaplin	Tina Fey	John F. Kennedy
Charlie Parker	Edith Piaf	Heath Ledger
Che Guevara	Rosa Parks	John Wilkes Booth
Christian Bale	Angelina Jolie	Vincent Van Gogh
Christopher Columbus	Dian Fossey	Bill Clinton
Christopher Hitchens	Carl Sagan	Judge Judy Sheindlin
Chuck Norris	Xena	Rainier Luftwaffe Wolfcastle
Cicero	Michelle Obama	Carl Lewis
Clark Gable	Brad Pitt	Bridget Jones
Clark Kent	Liz Lemon	Tim Berners-Lee
Cleopatra	Grigori Rasputin	Tina Fey
Julius Caesar	Coriolanus Snow	Anne Boleyn
Clint Eastwood	James Bond	Trinity
Colin Farrell	George Clooney	Courtney Love
Colonel Sanders	Violet Baudelaire	Reginald Jeeves
Confucius	Abraham Lincoln	Sarah Connor
Nicolaus Copernicus	Adam Smith	 
Cosmo Kramer	Dr. John Watson	Phoebe Buffay
Courtney Love	Bear Grylls	Britney Spears
Croesus	George Soros	Paris Hilton
Herodotus	Dame Edna Everage	James Comey
Daffy Duck	 	 
Dame Edna Everage	Benny Hill	Tina Fey
Dan Brown	John Grisham	 
Robert Langdon	Amelia Earhart	"Jeff ""Comic Book Guy"" Albertson"
Dan Quayle	 	 
Daniel Craig	Clint Eastwood	 
Daniel Boone	Xena	Tarzan
Dante Alighieri	Leonard Cohen	Dorothy Parker
Darth Maul	Catwoman	Darth Vader
Darth Vader	Darth Maul	Tina Turner
Davy Crockett	Amelia Earhart	Eliot Ness
David Beckham	Bruce Lee	Bridget Jones
David Blaine	Annie Oakley	Buzz Lightyear
David Bowie	Virginia Woolf	Kanye West
David Byrne	Dolly Parton	Eric Clapton
David Caruso	Margaret Thatcher	Nicolas Cage
David Hasselhoff	Basil Fawlty	Rachel Green
Dave Lee Roth	Mariah Carey	Anthony Scaramucci
David Letterman	Dame Edna Everage	Edmund Blackadder
David Lynch	Albert Einstein	Frida Kahlo
Dalton Trumbo	David Mamet	Dame Edna Everage
David Mamet	Angelina Jolie	Adam Sandler
Dean Martin	Lady Gaga	Buck Rogers
Deepak Chopra	Adam Smith	Bridget Jones
Dexter Morgan	Hannibal Lecter	Becky Sharp
Dian Fossey	Harvey Dent	Judge Judy Sheindlin
Dick Cheney	Jabba the Hutt	Mata Hari
Dolly Parton	Edith Piaf	Charles Foster Kane
Don Vito Corleone	Miss Jane Marple	Joseph Stalin
Don King	Madonna	J. Edgar Hoover
Donald Duck	Eliot Ness	Ann Coulter
Donald Trump	Imelda Marcos	Gordon Ramsay
Dorian Gray	Naomi Campbell	Oscar Wilde
Christian Grey	Bruce Wayne	Joan Crawford
Doris Day	Karen Carpenter	Donald Trump
Dorothy Parker	George Bernard Shaw	Selma Bouvier
Dr. John Watson	Ron Weasley	Marge Simpson
Professor James Moriarty	Dr. Greg House	Julia Roberts
Eddie Murphy	Mae West	Eminem
Eddie Van Halen	Franz Liszt	Tina Turner
Eddy Merckx	Britney Spears	Bill Clinton
Edith Piaf	Dolly Parton	Jean-Paul Sartre
Edward Hopper	Cary Grant	Emily Dickinson
Elizabeth Taylor	Angelina Jolie	Jerry Springer
Elmer Fudd	Eliot Ness	Jenna Maroney
Elmore Leonard	Christopher Hitchens	Courtney Love
Elvis Presley	Bono	Bridget Jones
Emily Dickinson	Sappho	Edward Hopper
Eminem	Dame Edna Everage	Eddie Murphy
Emperor Constantine	Queen Victoria	Julius Caesar
Ming The Merciless	Queen Victoria	Emperor Palpatine
Emperor Palpatine	Julius Caesar	Cersei Lannister
Erasmus	Frank Capra	Phoebe Buffay
Eric Clapton	Charlie Parker	Cameron Diaz
Ernest Hemingway	Dorothy Parker	Errol Flynn
Errol Flynn	Xena	Ernest Hemingway
Euclid	Lisbeth Salander	Andrew Lloyd Webber
Evel Knievel	Allan Quatermain	Amelia Earhart
Federico Fellini	Dean Martin	 
Fidel Castro	Joan of Arc	Julius Caesar
Flash Gordon	Amelia Earhart	George Clooney
Florence Nightingale	Mother Teresa	Flash Gordon
Forrest Gump	Florence Nightingale	Fredo Corleone
Francis Bacon	Batman	Frida Kahlo
Francis Crick	Ann Coulter	Muhammad Ali
Frank Capra	Erasmus	Phoebe Buffay
Frank Columbo	Ann Coulter	Steve Bannon
Frank Gehry	Bjork	Eddie Murphy
Frank Lloyd Wright	Frank Gehry	Ayn Rand
Frank Sinatra	Bono	Dian Fossey
Frank Zappa	Hunter S. Thompson	Gloria Steinem
Franz Liszt	Tina Turner	Peter Griffin
Fred Astaire	John Travolta	 
Fredo Corleone	George W. Bush	Phoebe Buffay
Garry Kasparov	Euclid	Dian Fossey
Garry Trudeau	Christopher Hitchens	Cameron Diaz
Garth Brooks	Taylor Swift	David Hasselhoff
Gary Larson	Barbra Streisand	David Byrne
Genghis Khan	Sarah Palin	Mr. Edward Hyde
George Bernard Shaw	Dorothy Parker	Archie Bunker
George Clooney	Bridget Jones	Flash Gordon
George Costanza	Charles Darwin	Ayn Rand
George Foreman	Modesty Blaise	 
George Harrison	Antonio Vivaldi	Cameron Diaz
George Orwell	Dalton Trumbo	Edith Piaf
George Soros	Imelda Marcos	El Chappo
George W. Bush	Ellen DeGeneres	David Beckham
George Washington	Cardinal Richelieu	Blanche DuBois
Gerard Manley Hopkins	Lou Reed	 
Megyn Kelly	Glenn Beck	 
Bill O'Reilly	Bridget Jones	Christopher Hitchens
Glenn Beck	Megyn Kelly	Nigel Farage
Gloria Steinem	Captain Ahab	Ann Coulter
Mikhail Gorbachev	George Orwell	Norma Desmond
Gordon Ramsay	Helen Keller	Donald Trump
Grace Kelly	Fred Astaire	Paris Hilton
Greta Garbo	Angelina Jolie	Jackson Pollock
Groucho Marx	Eddie Murphy	Imelda Marcos
Gwyneth Paltrow	Hugh Grant	Cameron Diaz
H.P. Lovecraft	Albert Einstein	Dian Fossey
Han Solo	Amelia Earhart	John Constantine
Jabba the Hutt	Maleficent	Al Capone
Hannibal Lecter	Dame Edna Everage	Auric Goldfinger
Harry Houdini	Catwoman	Napoleon Bonaparte
Harry Potter	Bertie Wooster	Liz Lemon
Lord Voldemort	Bill Gates	Cersei Lannister
Albus Dumbledore	Maleficent	Bobby Fischer
Heath Ledger	Meryl Streep	John Belushi
Helen Keller	Eliot Ness	 
Henry Ford	Michael O'Leary	Tina Fey
Henry James	Anton Chekov	 
Henry Kissinger	Karl Rove	Coco Chanel
Henry Miller	Madonna	Larry Flynt
Hercule Poirot	Sherlock Holmes	Rachel Green
Hillary Clinton	Harvey Dent	Tina Fey
Homer	Emily Dickinson	Charles Dickens
Homer Simpson	Atticus Finch	Bridget Jones
O.J. Simpson	Modesty Blaise	Tom Ripley
Mark Fuhrman	 	 
Howard Hughes	Imelda Marcos	Harvey Dent
Howard Stern	Benny Hill	Amy Schumer
Hugh Grant	Sarah Palin	Andrew Lloyd Webber
Hugh Hefner	Colonel Sanders	Courtney Love
Hugh Jackman	Charles Atlas	Ellen DeGeneres
Hulk Hogan	Rocky Balboa	 
Humphrey Bogart	Jimmy Cagney	Tina Fey
Imelda Marcos	Oprah Winfrey	The Joker
Indiana Jones	Allan Quatermain	Ann Coulter
Jack Bauer	James Bond	Xena
Jack Kerouac	Lara Croft	Charlie Harper
Jack Nicholson	Holly Golightly	Oedipus Rex
Jack The Ripper	Cleopatra	Genghis Khan
Jackie Chan	Annie Oakley	Arthur Conan Doyle
Jackson Pollock	Lizzy Bennet	Russell Crowe
James Bond	Napoleon Solo	Cersei Lannister
Auric Goldfinger	Imelda Marcos	Dr. Julius No
Ernst Stavro Blofeld	Don Vito Corleone	Cersei Lannister
Dr. Julius No	Marie Curie	Le Chiffre
Sir Hugo Drax	Cleopatra	Charles Foster Kane
Le Chiffre	Don Vito Corleone	Cersei Lannister
James Dean	Russell Crowe	Lara Croft
James Franco	Ben Affleck	Jenna Maroney
James Joyce	Jackson Pollock	Courtney Love
James T. Kirk	Helen Keller	Mayor Joe Quimby
Jamie Oliver	Fredo Corleone	 
Jane Austen	David Hasselhoff	Mary Poppins
Janis Joplin	Mick Jagger	Lindsay Lohan
Jar Jar Binks	Audrey Hepburn	Austin Powers
Jason Bourne	Catwoman	Michael Myers
Jay Leno	Johnny Carson	 
Jay Z	Amy Schumer	Donald Trump
JD Salinger	Dame Edna Everage	Howard Hughes
Beyoncé	Antonio Vivaldi	Kim Kardashian
Jeff Koons	Dalton Trumbo	Madonna
Jenna Jameson	Jim Jones	Elizabeth Taylor
Jeremy Clarkson	Mae West	Rush Limbaugh
Piers Morgan	Emma Bovary	Karl Lagerfeld
Jerry Lee Lewis	Jimi Hendrix	 
Jerry Lewis	Robin Williams	Lucille Ball
Jerry Seinfeld	Gary Larson	Bridget Jones
Jerry Springer	Kevin Smith	Elizabeth Taylor
Jesse Jackson	Jimmy Carter	Angelina Jolie
Jim Jones	Jimmy Cagney	Morgana Le Fay
Jim Morrison	Emily Dickinson	Hunter S. Thompson
Jimi Hendrix	Angelina Jolie	Jim Morrison
Jimmy Cagney	Humphrey Bogart	Marie Curie
Jimmy Carter	Christiane Amanpour	Charlie Brown
Jimmy Stewart	Bridget Jones	Garth Brooks
Joan Rivers	Jon Stewart	Ellen DeGeneres
Joaquin Phoenix	Al Pacino	Angela Merkel
Joe Biden	 	 
Joe Louis	Albus Dumbledore	Phoebe Buffay
Johann Sebastian Bach	Dolly Parton	Atticus Finch
John Belushi	Jerry Lewis	Bridget Jones
John Dillinger	Emma Bovary	Jack The Ripper
J. Edgar Hoover	Eliot Ness	Margaret Thatcher
John Grisham	Dan Brown	 
John Keats	Lord Byron	Gwyneth Paltrow
John Lennon	Leonard Cohen	Tina Fey
John Maynard Keynes	Marie Curie	 
John McCain	Anthony Bourdain	Cersei Lannister
John McEnroe	Lady Gaga	Bill O'Reilly
John Travolta	Grace Kelly	Hugh Jackman
John Wayne	James Bond	Judge Judy Sheindlin
Johnny Cash	Justin Timberlake	Billie Holiday
Jon Stewart	Robin Williams	Tina Fey
Jonathan Swift	Mae West	Al Gore
Joseph Goebbels	Britney Spears	Harvey Dent
Joseph Stalin	Maleficent	Pontius Pilate
Judas Iscariot	Jabba the Hutt	Emma Bovary
Judge Judy Sheindlin	Ellen Ripley	Bill O'Reilly
Julia Child	Cary Grant	Michelle Obama
Julia Roberts	Hugh Grant	Bridget Jones
Justin Bieber	Barbie	Peter Pan
Justin Timberlake	Dolly Parton	Harvey Dent
Kim Kardashian	Karl Rove	Paris Hilton
Kanye West	John Grisham	Bridget Jones
Karen Carpenter	Bono	Kate Moss
Karl Lagerfeld	Federico Fellini	Ann Coulter
Karl Marx	Jean-Paul Sartre	Dana Scully
Karl Rove	Kim Kardashian	Frank Underwood
Kate Moss	Hugh Grant	Paris Hilton
Keith Moon	Tina Turner	Hunter S. Thompson
Keith Richards	Edith Piaf	Ozzy Osbourne
Kevin Smith	Amy Schumer	Adam Sandler
Kim Philby	Tony Soprano	Emma Bovary
King Lear	Julius Caesar	Whitney Houston
Kobe Bryant	LeBron James	Julia Roberts
Kurt Cobain	Miles Davis	Virginia Woolf
Kurt Vonnegut	Garry Trudeau	Edna Krabappel
Lance Armstrong	Scarlett O'Hara	Richard Nixon
Lara Croft	Natasha Romanova	Barack Obama
Larry David	Joan Rivers	Alan Partridge
Larry Flynt	Megyn Kelly	Hugh Hefner
Larry King	Sarah Palin	Emperor Palpatine
Lee Harvey Oswald	Eliot Ness	 
Gordon Gekko	Bernard Madoff	Cersei Lannister
Lee Marvin	Lois Lane	Clint Eastwood
Leni Riefenstahl	Doris Day	Joseph Goebbels
Lenny Bruce	Roseanne Barr	Adam Sandler
Leo Tolstoy	Mahatma Gandhi	Angelina Jolie
Lex Luthor	Emma Bovary	"Wilson ""Kingpin"" Fisk"
Lindsay Lohan	Megan Fox	Charlie Parker
Linus Torvalds	Wilbur Wright	Joan Crawford
Lisa Simpson	Michelle Obama	Commissioner James Gordon
Lois Lane	Xena	Bob Woodward
Lord Byron	Emily Dickinson	Bruce Wayne
Lou Reed	Gerard Manley Hopkins	Barbra Streisand
Louis Armstrong	Ella Fitzgerald	 
Luciano Pavarotti	Frank Sinatra	Bridget Jones
Ludwig Van Beethoven	Louis Armstrong	Dorothy Parker
Luis Suarez	Bruce Lee	Lindsay Lohan
Luke Skywalker	Aung San Suu Kyi	Mahatma Gandhi
Niccolò Machiavelli	Queen Elizabeth I	Saul Goodman
Madonna	Lucille Ball	Jeff Koons
Mae West	Sarah Silverman	Larry Flynt
Mahatma Gandhi	Mother Teresa	Bobby Kennedy
Norma Desmond	Courtney Love	Mikhail Gorbachev
Mao Tse-tung	Carl Sagan	Cersei Lannister
Marcel Duchamp	Pablo Picasso	Lara Croft
Marco Pierre White	Don Draper	Diana Ross
Marco Polo	Albus Dumbledore	 
Margaret Thatcher	Ted Cruz	Dian Fossey
Marge Simpson	Florence Nightingale	Commissioner James Gordon
Mariah Carey	Bing Crosby	Lindsay Lohan
Marilyn Monroe	Jayne Mansfield	Charlie Parker
Mark Twain	Dame Edna Everage	Lou Reed
Marlene Dietrich	Catwoman	 
Marlon Brando	Greta Garbo	"Jeff ""Comic Book Guy"" Albertson"
Martha Stewart	Henry Ford	Nurse Ratched
Martin Luther King	Michelle Obama	Giacomo Casanova
Mata Hari	Jenna Jameson	Bernard Madoff
Matt Drudge	Alan Sugar	Cleopatra
Megan Fox	Barry White	Paris Hilton
Mel Brooks	Steve Martin	Elizabeth Taylor
Mel Gibson	Christian Bale	Sarah Palin
Meryl Streep	Heath Ledger	 
Mad Max Rockatansky	Noah	Arya Stark
Michael Bay	Michael Phelps	Tina Turner
Michael Corleone	Cleopatra	Keyser Söze
Michael Jackson	Miles Davis	Emily Dickinson
Michael Jordan	Wayne Gretzky	 
Michael Moore	Michelle Obama	Charles Foster Kane
Michael O'Leary	Donald Trump	Amy Schumer
Michael Phelps	Michael Jordan	Sarah Palin
Michelangelo	John McEnroe	Emily Dickinson
Michelle Obama	Lisa Simpson	Confucius
Mick Jagger	Miles Davis	Selena Gomez
Mickey Mouse	R2D2	Julia Child
Mike Tyson	Thor Odinson	Xena
Miles Davis	Ella Fitzgerald	Austin Powers
Miss Jane Marple	Reginald Jeeves	Lois Lane
Moses	Aung San Suu Kyi	Confucius
Mother Teresa	Pope Francis	Angelina Jolie
Muhammad Ali	Mae West	Pablo Picasso
Benito Mussolini	J. Edgar Hoover	Joan Crawford
Adolf Hitler	Queen Elizabeth I	Benito Mussolini
Napoleon Bonaparte	Oprah Winfrey	Charles Foster Kane
Ned Flanders	Bertie Wooster	Angelina Jolie
Neil Armstrong	Amelia Earhart	 
Nelson Mandela	Obi-wan Kenobi	 
Neville Chamberlain	Anne Frank	Fredo Corleone
Newt Gingrich	Elon Musk	Angelina Jolie
Nigella Lawson	Catwoman	 
Nikola Tesla	Leonardo Da Vinci	Emily Dickinson
Noah	Joan of Arc	Daniel Day-Lewis
Noam Chomsky	Carl Sagan	Angelina Jolie
Noël Coward	Mark Twain	Ann Coulter
Norman Rockwell	Orson Welles	Gwyneth Paltrow
Nostradamus	Obi-wan Kenobi	 
Obi-wan Kenobi	Mr. Miyagi	Emily Dickinson
Mr. Miyagi	Aung San Suu Kyi	Yoda
Oprah Winfrey	Napoleon Bonaparte	Bridget Jones
Orson Welles	Pablo Picasso	Lindsay Lohan
Wilbur Wright	Margaret Thatcher	Orville Wright
Orville Wright	Wilbur Wright	 
Oscar Wilde	Dame Edna Everage	Dorian Gray
Ozzy Osbourne	Tina Fey	Keith Richards
P. T. Barnum	Benjamin Franklin	 
Pablo Picasso	Leonardo Da Vinci	Bridget Jones
Pac Man	Jack The Ripper	 
Niccolò Paganini	Wolfgang Amadeus Mozart	 
Pamela Anderson	Benedict Arnold	Paris Hilton
Paris Hilton	Cameron Diaz	Ryan Reynolds
Patch Adams	Peter Griffin	Angelina Jolie
Paul McCartney	Dolly Parton	Sherlock Holmes
Perry Mason	Scipio Africanus	Coco Chanel
Pete Sampras	Katniss Everdeen	Roger Federer
Peter Griffin	Barbra Streisand	Seth MacFarlane
Peter Jackson	Beatrix Potter	Bill Gates
Brian Griffin	Lisa Simpson	Hunter S. Thompson
Peter Pan	Catwoman	Luis Suarez
Spider-Man	Batman	Tina Fey
Peter Parker	Lisa Simpson	Bill Gates
Doctor Stephen Strange	Aung San Suu Kyi	Steve Jobs
"Matt ""Daredevil"" Murdock"	Catwoman	George Armstrong Custer
"Wilson ""Kingpin"" Fisk"	Lex Luthor	Catherine The Great
Plato	Dame Edna Everage	Noam Chomsky
Adrian Monk	Jane Goodall	Harvey Dent
Pontius Pilate	George Smiley	Tina Fey
Pope Benedict XVI	Lisa Simpson	Alan Partridge
Pope Francis	Mahatma Gandhi	 
Quentin Tarantino	Mark Twain	Imelda Marcos
Ralph Nader	Atticus Finch	Queen Victoria
Grigori Rasputin	Lucifer	Cersei Lannister
Ray Kroc	Peter Jackson	Dian Fossey
Raymond Chandler	Dame Edna Everage	Eliot Ness
Richard Branson	Warren Buffett	Rachel Green
Richard Dawkins	Ann Coulter	Karl Lagerfeld
Richard Nixon	Condoleezza Rice	Dick Cheney
Richie Rich	Croesus	Paris Hilton
Ricky Martin	Dolly Parton	John Grisham
Ridley Scott	Federico Fellini	Pamela Anderson
Ringo Starr	Jamie Oliver	 
Robbie Williams	Dolly Parton	Kanye West
Robert De Niro	Daniel Day-Lewis	Cameron Diaz
Robert Redford	Tina Fey	Mick Jagger
Robin Hood	Malcolm X	Catwoman
Robin Williams	Joan Rivers	Vincent Van Gogh
Robinson Crusoe	Helen Keller	Salman Rushdie
Rocky Balboa	Hulk Hogan	Sarah Palin
Roger Federer	Katniss Everdeen	Pete Sampras
Ron Weasley	Ellen DeGeneres	Sterling Archer
Rudy Giuliani	Hillary Clinton	Bill O'Reilly
Rupert Murdoch	William Randolph Hearst	Mata Hari
Rush Limbaugh	Sean Hannity	Ann Coulter
Russell Crowe	Will Smith	Greta Garbo
Salman Rushdie	Voltaire	Emily Dickinson
Salvador Dali	Pablo Picasso	Bridget Jones
Sam Spade	Philip Marlowe	Queen Elizabeth I
Philip Marlowe	Miss Jane Marple	Humphrey Bogart
Samson	Xena	Neville Chamberlain
Samuel Johnson	Mark Twain	Norma Desmond
Samuel Pepys	Ellen Ripley	 
Santa Claus	Lizzy Bennet	"Jeff ""Comic Book Guy"" Albertson"
Sarah Palin	Hugh Grant	Paris Hilton
Savonarola	Ayatollah Khomeini	Angelina Jolie
Scipio Africanus	Bobby Fischer	Doris Day
Sean Connery	Hugh Grant	 
Seth MacFarlane	Tina Fey	Adam Sandler
Matt Groening	Jerry Seinfeld	Liz Lemon
Sherlock Holmes	Saga Norén	Dr. Greg House
Shirley Temple	Stevie Wonder	Cameron Diaz
Sid Vicious	Emma Bovary	Beetlejuice
Sigmund Freud	Charles Darwin	Mae West
Simon Cowell	Rush Limbaugh	Ann Coulter
Sheldon Cooper	Frank Columbo	Bridget Jones
Leonard Hofstadter	Bertie Wooster	Edith Piaf
Spongebob Squarepants	Kenneth Parcell	Chelsea Manning
Stan Lee	Charlie Chaplin	Dolly Parton
Squidward Tentacles	 	 
Stephen Colbert	Sarah Silverman	Donald Trump
Stephen Hawking	Professor Charles Xavier	Julia Roberts
Mr. Krabs	Warren Buffett	 
Steve Ballmer	Elton John	Dian Fossey
Steve Jobs	Tony Stark	Dian Fossey
Steve Martin	Mae West	Weird Al Yankovic
Steven Spielberg	Rush Limbaugh	Florence Nightingale
Stewie Griffin	Jor El	Lisbeth Salander
Sun Tzu	Queen Elizabeth I	Donald Rumsfeld
Svengali	Grigori Rasputin	Coco Chanel
Sylvester Stallone	John Rambo	Sarah Palin
John Rambo	Sylvester Stallone	Sarah Palin
Tarzan	Hulk Hogan	Pocahontas
Theodore Roosevelt	Ernest Hemingway	Judge Judy Sheindlin
Thomas Edison	Emily Dickinson	Don King
Thomas Pynchon	William Shakespeare	Emily Dickinson
Tiger Woods	Lara Croft	Tom Jones
Tina Turner	Edith Piaf	Al Pacino
Tom Cruise	Madonna	Daniel Day-Lewis
Tom Hanks	Heath Ledger	Cameron Diaz
Tom Jones	Ricky Martin	Anna Karenina
Tom Sawyer	Bart Simpson	 
Tom Waits	Madonna	Leonard Cohen
Tony Blair	Ann Coulter	Bill Clinton
Huckleberry Finn	Katniss Everdeen	The Artful Dodger
Tony Robbins	Buddha	Bridget Jones
Tony Soprano	Violet Baudelaire	Mike Tyson
Tony Stark	Grace Hopper	Sergey Brin
Tomás de Torquemada	Joan of Arc	Al Capone
Leon Trotsky	Vladimir Lenin	Emily Dickinson
Tony Montana	King Richard III	Xena
Victor Meldrew	Sylvia Plath	Squidward Tentacles
Vincent Van Gogh	Salvador Dali	Holly Golightly
Virginia Woolf	Salman Rushdie	Sylvia Plath
Vladimir Lenin	Leon Trotsky	Catherine The Great
Vladimir Putin	Aung San Suu Kyi	Benito Mussolini
Voltaire	Virginia Woolf	Allan Quatermain
Carl Von Clausewitz	Miss Jane Marple	Ariel Sharon
Walt Disney	Kim Kardashian	Christian Grey
Walt Whitman	Lord Byron	 
Walter White	Miss Jane Marple	Frank Underwood
Warren Buffett	Lucille Ball	 
Wayne Gretzky	Michael Jordan	 
Wayne Rooney	Bruce Lee	Dame Edna Everage
Weird Al Yankovic	Benny Hill	Lucille Ball
Will Smith	Heath Ledger	Angela Merkel
William Randolph Hearst	Imelda Marcos	Rupert Murdoch
William Shakespeare	Salman Rushdie	Mae West
William Shatner	Dame Edna Everage	David Hasselhoff
Willy Wonka	Doris Day	Robinson Crusoe
Winston Churchill	Virginia Woolf	Enrico Caruso
Wolfgang Amadeus Mozart	Niccolò Paganini	Mae West
Kenny G	Dolly Parton	Green Lantern
Woody Allen	Dame Edna Everage	Kim Jung-un
Woody Guthrie	Dolly Parton	Gandalf the Grey
Wyatt Earp	Peter Pan	Maleficent
Yogi Berra	Ellen DeGeneres	Yoda
Zsa Zsa Gabor	Kim Kardashian	Ryan Reynolds
Pinocchio	Bart Simpson	Rosa Parks
Yoda	Albus Dumbledore	Edith Piaf
Saul Goodman	Yogi Berra	Coco Chanel
Stanley Kowalski	Anna Karenina	John Wilkes Booth
Blanche DuBois	Grace Kelly	George Washington
Ron Burgundy	Courtney Love	Silvio Berlusconi
Rain Man	Florence Nightingale	Larry David
Inspector Gadget	Wile E. Coyote	Jenna Maroney
Professor Hans Zarkov	Peter Parker	 
H.A.L. 9000	Dexter Morgan	Martha Stewart
Walter Mitty	Frida Kahlo	Dan Quayle
Xena	Modesty Blaise	Genghis Khan
Inspector Jacques Clouseau	Alan Partridge	Diana Ross
Joey Tribbiani	Barney Rubble	Jenna Maroney
Chandler Bing	Adam Sandler	Tina Fey
Monica Geller	 	 
Ross Geller	Lara Croft	Donald Trump
Rachel Green	Coco Chanel	Derek Zoolander
Phoebe Buffay	Ophelia	Forrest Gump
Liz Lemon	Tina Fey	Bill Gates
Jack Donaghy	Cersei Lannister	Han Solo
Tracy Jordan	Dorothy Parker	Elmer Fudd
Jenna Maroney	Meghan Markle	Tracy Jordan
Kenneth Parcell	Phoebe Buffay	Bradley Manning
Mr. Spock	Walter White	Lara Croft
Jesse Pinkman	Katniss Everdeen	Heath Ledger
Gustavo Fring	Judge Judy Sheindlin	Cardinal Richelieu
Don Draper	Greta Garbo	Stephen Hawking
Leroy Jethro Gibbs	George Smiley	Tina Fey
Tony DiNozzo	Bridget Jones	Adam Sandler
Timothy McGee	Condoleezza Rice	Bill Gates
Tyrion Lannister	Saga Norén	Bilbo Baggins
Cersei Lannister	Jack Donaghy	Catherine The Great
Jaime Lannister	Aung San Suu Kyi	Charles Foster Kane
Eddard Stark	Don Vito Corleone	Queen Elizabeth I
Chewbacca	Olive Oyl	Arnold Schwarzenegger
C-3PO	Reginald Jeeves	Bridget Jones
R2D2	James Bond	Cersei Lannister
Marty McFly	Aung San Suu Kyi	Antonio Vivaldi
Doc Emmett Brown	Marie Curie	Professor Hans Zarkov
Biff Tannen	 	 
George McFly	Reginald Jeeves	Liz Lemon
Dirty Harry Callahan	Wolverine	Xena
Sonny Crockett	Michelle Obama	Bill O'Reilly
Inspector Endeavour Morse	William Shakespeare	Katharine Hepburn
Rico Tubbs	Nigella Lawson	Johnny Depp
Jean-Luc Picard	Virginia Woolf	Daniel Day-Lewis
Commander Data	Walter White	Saga Norén
Edward Cullen	Scarlett O'Hara	Jimmy Cagney
Alan Partridge	Olive Oyl	Larry David
Dr. Greg House	Saga Norén	Sherlock Holmes
Edmund Blackadder	Jack Sparrow	Dame Edna Everage
Baldrick	Dr. John Watson	Paris Hilton
Lord Percy Percy	Lt. George Colthurst St Barleigh	Jenna Maroney
Lt. George Colthurst St Barleigh	Lord Percy Percy	Jenna Maroney
The Scarlet Pimpernel	Jason Bourne	 
Leonardo Da Vinci	Nikola Tesla	 
Hamlet	Virginia Woolf	Harvey Dent
Polonius	Archie Bunker	 
Ophelia	Atticus Finch	Bridget Jones
Romeo Montague	Frodo Baggins	Juliet Capulet
Juliet Capulet	Dexter Morgan	Bridget Jones
Adolf Eichmann	J. Edgar Hoover	Ayn Rand
Bruce Banner	Alan Turing	Emily Dickinson
Frasier Crane	Sideshow Bob	Blanche DuBois
Niles Crane	Frasier Crane	Katharine Hepburn
Freddy Krueger	Tim Burton	Dame Edna Everage
Keyser Söze	Julius Caesar	Lisbeth Salander
Daphne Moon	Shrek	Miss Jane Marple
Moe Szyslak	Atticus Finch	Pocahontas
Barney Gumble	Fredo Corleone	Liz Lemon
Fred Flintstone	Barney Rubble	Dian Fossey
Barney Rubble	Fred Flintstone	 
Michael Myers	Tweety Pie	Jason Voorhees
Jason Voorhees	Tweety Pie	Michael Myers
Barney Stinson	Tony DiNozzo	Cleopatra
"Erik ""Magneto"" Lehnsherr"	Dexter Morgan	Cersei Lannister
Professor Charles Xavier	Hannibal Lecter	Angelina Jolie
Rocket Raccoon	Emma Bovary	Deadpool
Groot	Xena	Chuck Norris
Bugs Bunny	Dexter Morgan	 
Shrek	Groot	Amy Schumer
Porky Pig	Edward Scissorhands	Bridget Jones
Yosemite Sam	John McEnroe	Judge Judy Sheindlin
Wile E. Coyote	Mr. Bean	Julia Roberts
George Smiley	Leroy Jethro Gibbs	 
Captain America	Xena	Morpheus
Bilbo Baggins	Aung San Suu Kyi	Frodo Baggins
Frodo Baggins	Bilbo Baggins	Edith Piaf
Samwise Gamgee	Ann Coulter	Bilbo Baggins
John McClane	Helen Keller	Daniel Boone
Optimus Prime	Katniss Everdeen	Edward Scissorhands
Jack Sparrow	Edmund Blackadder	Mata Hari
Edward Scissorhands	Phoebe Buffay	Michael Jackson
Beetlejuice	Anthony Bourdain	Ann Coulter
Olive Oyl	Chewbacca	Emma Bovary
Popeye	Frodo Baggins	Dolly Parton
Pepé Le Pew	Giacomo Casanova	Dian Fossey
Sideshow Bob	Frasier Crane	Bridget Jones
John Merrick	Maximus Decimus Meridius	Courtney Love
Ed Wood	Dian Fossey	Inspector Jacques Clouseau
Maximus Decimus Meridius	Jason Bourne	Dorothy Parker
Gore Vidal	Virginia Woolf	George Washington
Truman Capote	Gore Vidal	Joan Rivers
Spartacus	James T. Kirk	Cersei Lannister
Mr. Bean	Wile E. Coyote	Emily Dickinson
Monsieur Hulot	Bridget Jones	Mr. Bean
Derek Zoolander	Dorian Gray	Rachel Green
Dr. Strangelove	Peter Parker	Blanche DuBois
E.T.	Groot	Edith Piaf
Dr. Evil	Emma Bovary	Sideshow Bob
Scott Evil	Wesley Crusher	Bridget Jones
Bane	Sylvester Stallone	Selma Bouvier
Naomi Campbell	Melania Trump	Donald Trump
Sarah Jessica Parker	 	 
Kevin Bacon	Daniel Day-Lewis	 
Hans Gruber	Anna Karenina	Cardinal Richelieu
Antonio Salieri	Hans Gruber	Morgana Le Fay
Saruman the White	Sauron	Mata Hari
Gandalf the Grey	Dame Edna Everage	Woody Guthrie
Sauron	Morgana Le Fay	Lucifer
Maleficent	Cleopatra	General Zod
Norman Bates	Violet Baudelaire	Jim Jones
Nigel Tufnel	Eddie Van Halen	Phoebe Buffay
Judge Joe Dredd	Aung San Suu Kyi	Theodore Roosevelt
Wesley Crusher	Miss Jane Marple	Bob Dylan
Sarah Silverman	Stephen Colbert	Roseanne Barr
Tweety Pie	Pac Man	 
Sylvester the Cat	Eliot Ness	Lizzy Bennet
Ronald McDonald	Spongebob Squarepants	 
The HamBurglar	The Joker	Imelda Marcos
Osama Bin Laden	Emma Bovary	The Joker
Saddam Hussein	Emma Bovary	Ming The Merciless
Ayatollah Khomeini	Savonarola	Angelina Jolie
Leonardo DiCaprio	Marilyn Monroe	Jared Kushner
Jay Gatsby	Harriet Tubman	Niles Crane
Michael J. Fox	Mae West	Al Gore
Ellen Ripley	Leroy Jethro Gibbs	Bjork
Clarice Starling	Hillary Clinton	Sonny Crockett
Scarlett O'Hara	Rocky Balboa	Jenna Maroney
Modesty Blaise	Sydney Bristow	Francis Crick
Sarah Connor	John Rambo	Ann Coulter
Condoleezza Rice	Madeleine Albright	Severus Snape
Donald Rumsfeld	Dexter Morgan	Ivanka Trump
Lisbeth Salander	Euclid	Lindsay Lohan
Princess Leia Organa	Dian Fossey	Christian Bale
Hermione Granger	Euclid	Daenerys Targaryen
Sydney Bristow	Hulk Hogan	Ophelia
Dana Scully	Hermione Granger	Mike  Pence
Marie Curie	Dana Scully	Jimmy Cagney
Tim Burton	The Joker	Frida Kahlo
Coco Chanel	Dian Fossey	Cardinal Richelieu
Fox Mulder	Matt Groening	Selma Bouvier
Bruce Willis	Robert Downey Jr.	Hedda Gabler
Robert Downey Jr.	Mel Brooks	Bridget Jones
Michael Schumacher	Napoleon Solo	Ayn Rand
Oscar Pistorius	Kobe Bryant	Boudicca
Bernard Madoff	Reginald Jeeves	Mata Hari
Julian Assange	Larry Flynt	Coco Chanel
Tom Ripley	Cary Grant	Mata Hari
Mrs. Doubtfire	Ophelia	Confucius
Kim Jong-Il	Kim Jung-un	Bridget Jones
Kim Jung-un	Imelda Marcos	Kim Jong-Il
Simon Pegg	Tina Fey	Bill Gates
Anne Boleyn	Eliot Ness	Emma Bovary
King Henry VIII	Kim Jong-Il	Bridget Jones
Angela Merkel	Queen Elizabeth I	Batman
Silvio Berlusconi	Christian Grey	Lindsay Lohan
Princess Fiona	Ophelia	John McCain
Victor Frankenstein	Harvey Dent	Anne Boleyn
Count Dracula	Lucifer	Natasha Romanova
Jim Carrey	Robin Williams	Jenna Maroney
General George Patton	Ellen Ripley	Don Vito Corleone
John F. Kennedy	Che Guevara	Anna Karenina
Nicolas Sarkozy	Catherine The Great	Donald Trump
Dominique Strauss-Kahn	Lex Luthor	Anna Karenina
Alexander the Great	Emma Bovary	Saddam Hussein
Pocahontas	Thor Odinson	Chelsea Manning
Amelia Earhart	Charles Lindbergh	Jenna Maroney
Charles Lindbergh	Allan Quatermain	 
Frida Kahlo	Albert Einstein	Selma Bouvier
Judy Garland	Ella Fitzgerald	Charlie Parker
Ella Fitzgerald	Ray Charles	Audrey Hepburn
Sylvia Plath	Miss Jane Marple	Leonard Cohen
Nicolas Cage	Amy Winehouse	David Caruso
Malcolm X	Moses	Dian Fossey
Rosa Parks	Maximus Decimus Meridius	 
Sean Penn	Russell Crowe	Diana Ross
Mickey Rourke	Angelina Jolie	Keith Moon
Elton John	The Joker	Joan Rivers
Bradley Manning	Edward Snowden	Chelsea Manning
Chelsea Manning	Bradley Manning	Pocahontas
Tim Berners-Lee	Nikola Tesla	Cameron Diaz
Edward Snowden	Chelsea Manning	Bradley Manning
Sergey Brin	Larry Page	Liz Lemon
Larry Page	Marie Curie	Sergey Brin
Montgomery Burns	Croesus	Ayn Rand
Waylon Smithers	Condoleezza Rice	Larry King
Mayor Joe Quimby	Sarah Palin	James T. Kirk
Chief Clarence Wiggum	Neville Chamberlain	Bridget Jones
Lionel Hutz	Bridget Jones	Inspector Jacques Clouseau
Troy McClure	Colin Farrell	Bridget Jones
Rainier Luftwaffe Wolfcastle	Arnold Schwarzenegger	Sarah Palin
Krusty the Clown	Ellen DeGeneres	Rick Deckard
Edna Krabappel	Captain Ahab	 
Kent Brockman	Bridget Jones	Ron Burgundy
Hans Moleman	Nigella Lawson	Eliot Ness
Selma Bouvier	Jack Bauer	Ann Coulter
Principal Seymour Skinner	Simone de Beauvoir	General George Patton
Nelson Muntz	Sarah Palin	Donald Duck
Groundskeeper Willie MacDougal	Sarah Connor	Oedipus Rex
"Thomas ""Neo"" Anderson"	Morpheus	Dana Scully
Morpheus	Scarlett O'Hara	Captain America
Trinity	Xena	Clint Eastwood
Agent Smith	"Thomas ""Neo"" Anderson"	Nurse Ratched
Glenn Quagmire	Tina Turner	Christian Grey
Uri Geller	Annie Oakley	Saddam Hussein
Jeffrey Lebowski	Bridget Jones	Lenny Bruce
Iggy Pop	Quentin Tarantino	Stormy Daniels
Mark Zuckerberg	Nikola Tesla	Liz Lemon
Roy Batty	Conan the Barbarian	Imelda Marcos
Rick Deckard	Aung San Suu Kyi	Humphrey Bogart
Dr. Eldon Tyrell	Mark Zuckerberg	Nurse Ratched
Thor Odinson	Hellboy	Julia Roberts
Loki Laufeyson	Bridget Jones	Lord Voldemort
Richard B. Riddick	Xena	Jack The Ripper
Alan Turing	Leonardo Da Vinci	 
Conan the Barbarian	Red Sonja	Wolverine
Red Sonja	Conan the Barbarian	Xena
"Jeff ""Comic Book Guy"" Albertson"	Lara Croft	Barry White
King Richard III	Queen Elizabeth I	Sauron
Queen Elizabeth I	Miss Jane Marple	Barack Obama
Dr. Henry Jekyll	Reginald Jeeves	Joan of Arc
Mr. Edward Hyde	Xena	The Joker
Travis Bickle	Dian Fossey	Harvey Dent
Tyler Durden	Steve Jobs	Joan of Arc
Sam Winchester	Simone de Beauvoir	Scott Evil
Dean Winchester	Tina Fey	Bill O'Reilly
Jesus Christ	Sam Winchester	Angelina Jolie
Lucifer	Morgana Le Fay	Sauron
Eric Cartman	Sam Spade	Bridget Jones
Agent Phil Coulson	Ron Weasley	Sarah Connor
Nick Fury	Tyrion Lannister	Judge Judy Sheindlin
Russell Brand	Joan Rivers	Al Gore
Jeremy Paxman	Simone de Beauvoir	Noam Chomsky
Boris Johnson	Bridget Jones	Cary Grant
Ebenezer Scrooge	Croesus	Dian Fossey
Wilkins Micawber	Lt. George Colthurst St Barleigh	Lindsay Lohan
Fagin	Cleopatra	Dick Cheney
The Artful Dodger	Darth Maul	Pippi Longstocking
Uriah Heap	Tony Montana	Nurse Ratched
Bob Cratchit	Jesus Christ	 
Tiny Tim Cratchit	Phoebe Buffay	Charlie Brown
Jean-Paul Sartre	Thomas Aquinas	Edith Piaf
Simone de Beauvoir	Virginia Woolf	Jean-Paul Sartre
Monica Lewinsky	Bill O'Reilly	Lindsay Lohan
Colonel Kurtz	Moses	Xena
Jor El	Albert Einstein	Angelina Jolie
Kal El	Superman	 
General Zod	Scarlett O'Hara	Dr. Strangelove
Lizzy Bennet	Lara Croft	Dante Alighieri
Mr. Darcy	Bertie Wooster	Blanche DuBois
John Constantine	Romeo Montague	Tina Fey
Hellboy	Thor Odinson	Judge Judy Sheindlin
Charlie Harper	Carrie Bradshaw	Hugh Hefner
Snake Plissken	Conan the Barbarian	Trinity
Severus Snape	Aung San Suu Kyi	Batman
Borat	Jay Leno	Phoebe Buffay
Ali G	Jon Stewart	Jane Austen
Jack Reacher	Samson	Dian Fossey
Arthur Dent	Bertie Wooster	Jane Austen
Del Boy Trotter	Lizzy Bennet	Cary Grant
Captain William Bligh	John Wilkes Booth	Ayn Rand
Fletcher Christian	Harriet Tubman	Spartacus
Frank Underwood	Hannibal Lecter	Becky Sharp
Napoleon Solo	Violet Baudelaire	Barney Stinson
Quasimodo	Ann Coulter	John Merrick
Ilya Kuryakin	Aung San Suu Kyi	Al Gore
Wolverine	Judge Judy Sheindlin	Jack The Ripper
Deadpool	Jack Bauer	Mae West
Green Lantern	Violet Baudelaire	Kenny G
Superman	Kal El	Angelina Jolie
Ryan Reynolds	Brad Pitt	Paris Hilton
Coriolanus Snow	Queen Elizabeth I	Sauron
Don Quixote	Emma Bovary	Norman Bates
Baron Munchausen	Adam Sandler	Margaret Thatcher
Hunter S. Thompson	Christopher Hitchens	Lindsay Lohan
Lando Calrissian	Bridget Jones	Mark Fuhrman
Bob Woodward	Nancy Drew	Carl Bernstein
Carl Bernstein	Bob Woodward	Miss Jane Marple
G. Gordon Liddy	Kellyanne Conway	Ariel Sharon
Anthony Scaramucci	Imelda Marcos	Harvey Weinstein
Melania Trump	Naomi Campbell	Severus Snape
Christiane Amanpour	Nancy Drew	Commissioner James Gordon
Bobby Kennedy	Christiane Amanpour	Mahatma Gandhi
James Comey	Eliot Ness	Christiane Amanpour
Robert Mueller	Helen Keller	Carl Bernstein
Sean Hannity	Dorothy Parker	Rush Limbaugh
Kellyanne Conway	Bridget Jones	Archie Bunker
Harvey Weinstein	Don King	Bette Midler
Kevin Spacey	Cary Grant	Cleopatra
Stormy Daniels	Catwoman	Jerry Springer
Deep Throat	Miss Jane Marple	Richard Nixon
Gianni Versace	Beatrix Potter	Al Pacino
Reince Priebus	Waylon Smithers	Ivanka Trump
Mike  Pence	Reginald Jeeves	Sarah Connor
Tom Wolfe	Carrie Bradshaw	Steve Bannon
Steve Bannon	Miss Jane Marple	Nigel Farage
Jared Kushner	Buddy Holly	Cameron Diaz
Ivanka Trump	Meghan Markle	Donald Rumsfeld
Jeff Sessions	Miss Jane Marple	Mike  Pence
Ted Cruz	Che Guevara	Dian Fossey
Thanos	Hillary Clinton	O.J. Simpson
Emmanuel Macron	Bill Clinton	Rachel Green
Nigel Farage	Bridget Jones	Steve Bannon
Elon Musk	Lex Luthor	Anne Boleyn
Jeff Bezos	Rupert Murdoch	Anne Boleyn
Lars von Trier	Bjork	Tupac Shakur
Bjork	Karen Carpenter	Alan Sugar
El Chappo	Pablo Escobar	Madonna
Pablo Escobar	Imelda Marcos	El Chappo
King David	Spider-Man	Anna Karenina
King Solomon	Queen Elizabeth I	Al Capone
Rick Sanchez	Archimedes	Ayn Rand
Morty Smith	Florence Nightingale	Bob Dylan
Barbie	Tyra Banks	Ryan Reynolds
Johnny Carson	Ellen DeGeneres	David Hasselhoff
Billie Holiday	Ella Fitzgerald	Johnny Cash
James Brown	Bono	Tina Turner
Stevie Wonder	Karen Carpenter	Homer
Boy George	Tina Fey	RuPaul
Buddy Holly	Tina Fey	David Byrne
Cher	Whitney Houston	Al Gore
Amy Schumer	Ellen DeGeneres	Howard Stern
Lucille Ball	Benny Hill	Phoebe Buffay
Jerry Maguire	Anne Frank	Kent Brockman
Joe DiMaggio	Serena Williams	Don King
Katharine Hepburn	Christian Bale	Ellen Ripley
Janet Jackson	Michael Jackson	Stormy Daniels
Jayne Mansfield	Che Guevara	Marilyn Monroe
RuPaul	Jerry Springer	Conchita Wurst
Sammy Davis Jr.	Robert Downey Jr.	Selena Gomez
Ray Charles	Miles Davis	Helen Keller
Lady Gaga	Mariah Carey	Gianni Versace
Whitney Houston	Bono	Amy Winehouse
Rihanna	Whitney Houston	Pontius Pilate
Rafael Nadal	Novak Djokovic	Serena Williams
Amy Winehouse	Bono	Lady Gaga
Serena Williams	Modesty Blaise	Rafael Nadal
Tupac Shakur	Edith Piaf	Lars von Trier
Christina Aguilera	Amy Winehouse	Gianni Versace
Dr. Dre	Imelda Marcos	Lars von Trier
Princess Diana	Grace Kelly	Ryan Reynolds
Ellen DeGeneres	Jay Leno	Joan Rivers
Katy Perry	Mae West	James Franco
Selena Gomez	Bridget Jones	Mick Jagger
Johnny Depp	Bjork	Edgar Allan Poe
Cristiano Ronaldo	Rafael Nadal	Selena Gomez
Tom Brady	Serena Williams	Confucius
Tyra Banks	Sonny Crockett	Doris Day
Zac Efron	Jay Leno	Grace Kelly
Novak Djokovic	Rafael Nadal	Cameron Diaz
Usain Bolt	Kobe Bryant	 
Ashton Kutcher	Ellen DeGeneres	Zac Efron
Ariana Grande	Bono	Whitney Houston
Winona Ryder	Emma Bovary	Bobby Fischer
Conchita Wurst	Lizzy Bennet	Boy George
Scarlett Johansson	Tyra Banks	Indiana Jones
Caitlyn Jenner	Albus Dumbledore	Grace Kelly
Marc Jacobs	Ridley Scott	Bridget Jones
LeBron James	Trinity	Donald Trump
Barbra Streisand	Bette Midler	Bob Dylan
Grace Jones	Bruce Lee	Scarlett Johansson
Diana Ross	Bono	Bridget Jones
Liza Minnelli	Tina Fey	Charlie Parker
Joan Crawford	Daniel Day-Lewis	Bette Davis
Bette Davis	Bono	Joan Crawford
Kylie Minogue	Bridget Jones	Ryan Reynolds
Bette Midler	Barbra Streisand	Adam Sandler
George Michael	Bjork	Cristiano Ronaldo
Harvey Milk	Margaret Mead	Tupac Shakur
Freddie Mercury	Lady Gaga	Steve Ballmer
Morrissey	Bob Dylan	Coco Chanel
Chris Rock	Lenny Bruce	Stormy Daniels
Kylo Ren	Emma Bovary	Christian Bale
Taylor Swift	Bono	Audrey Hepburn
Meghan Markle	Noam Chomsky	Emma Bovary
Martin Luther	Joan of Arc	Fletcher Christian
Isaac Newton	Galileo Galilei	Miss Havisham
Ronald Reagan	Bridget Jones	Jeff Sessions
Friedrich Nietzsche	William Shakespeare	Norma Desmond
Galileo Galilei	Isaac Newton	Boudicca
Oliver Cromwell	Eliot Ness	Xena
Edgar Allan Poe	Leonard Cohen	Frida Kahlo
Joseph Smith	Joan of Arc	Julian Assange
Immanuel Kant	Friedrich Nietzsche	 
Richard Wagner	Pyotr Ilyich Tchaikovsky	Roseanne Barr
Pyotr Ilyich Tchaikovsky	Richard Wagner	Emily Dickinson
Socrates	Karl Marx	Christiane Amanpour
Robert E. Lee	Don Vito Corleone	Sarah Palin
King Arthur	Optimus Prime	Margaret Thatcher
Sir Lancelot	King Arthur	Emma Bovary
Merlin	Jabba the Hutt	Daphne Moon
Morgana Le Fay	Sauron	Miss Havisham
Johann von Goethe	Simone de Beauvoir	Leo Tolstoy
Thomas Aquinas	Simone de Beauvoir	Buddha
René Descartes	Buddha	Dana Scully
Harry S. Truman	John Wilkes Booth	Boudicca
Joan of Arc	Martin Luther	Stormy Daniels
John Calvin	Martin Luther	Angelina Jolie
William the Conqueror	Hillary Clinton	Auric Goldfinger
Saint Peter	Joan of Arc	Oedipus Rex
Saint Paul	Ann Coulter	Ralph Nader
James Cook	Clarice Starling	 
Queen Victoria	Julius Caesar	Martha Stewart
Thomas Jefferson	Simone de Beauvoir	Polonius
Johannes Gutenberg	Archimedes	 
Pythagoras	Bob Dylan	Daphne Moon
Archimedes	Bjork	Victor Meldrew
Louis Pasteur	Archimedes	Olive Oyl
Anne Frank	Aung San Suu Kyi	Jackson Pollock
J.R.R. Tolkein	Albert Einstein	 
Otto von Bismarck	Reginald Jeeves	Cersei Lannister
Sophocles	Friedrich Nietzsche	Frida Kahlo
Oedipus Rex	Dexter Morgan	Boudicca
Gregor Mendel	Frank Columbo	Rihanna
Sitting Bull	Perry Mason	Marie Curie
George Armstrong Custer	Aung San Suu Kyi	Donald Trump
Alexander Fleming	Frank Columbo	Pippi Longstocking
Wernher von Braun	Clarice Starling	Oliver Cromwell
Alfred Nobel	Marie Curie	Eliot Ness
Rembrandt	Beatrix Potter	Ted Cruz
Ferdinand Magellan	Helen Keller	Grigori Rasputin
Grace Hopper	Ann Coulter	Daffy Duck
Margaret Mead	Eleanor Roosevelt	Daffy Duck
Sappho	Emily Dickinson	Dante Alighieri
Harriet Tubman	Spartacus	 
Catherine The Great	Nicolas Sarkozy	Cersei Lannister
Annie Oakley	Tina Fey	 
Eleanor Roosevelt	Noam Chomsky	Annie Oakley
Jane Goodall	Frank Columbo	 
Madeleine Albright	Noah	Roseanne Barr
Emmeline Pankhurst	Harvey Milk	Gloria Steinem
Boudicca	Scipio Africanus	Red Sonja
Natasha Romanova	Lara Croft	Sauron
Lady Macbeth	Joseph Stalin	Becky Sharp
Lord Macbeth	Harriet Tubman	The Joker
Shylock	Jack Sparrow	Morgana Le Fay
Jane Eyre	Noam Chomsky	Edith Piaf
Arya Stark	Bear Grylls	Miss Havisham
Katniss Everdeen	Optimus Prime	 
Mary Poppins	Florence Nightingale	Confucius
Daenerys Targaryen	Eliot Ness	Hermione Granger
Pippi Longstocking	Forrest Gump	Liz Lemon
Becky Sharp	Catwoman	Frank Underwood
Tess Durbeyfield	Dana Scully	Timothy McGee
Nancy Drew	Ann Coulter	Bob Woodward
Eliza Doolittle	Oedipus Rex	Stormy Daniels
Holly Golightly	Katharine Hepburn	Christian Bale
Miss Havisham	Croesus	Morgana Le Fay
Buffy Summers	Chuck Norris	Marie Curie
Helen of Troy	Catwoman	Charlie Chaplin
Nurse Ratched	 	 
Cinderella	Eleanor Roosevelt	Jimmy Cagney
Violet Baudelaire	Ellen Ripley	Victor Meldrew
Peter Rabbit	Tweety Pie	 
Hedda Gabler	Dave Lee Roth	Cersei Lannister
Father Ted	Bertie Wooster	 
Saga Norén	Sherlock Holmes	Condoleezza Rice
Winnie the Pooh	Emily Dickinson	Erasmus
Willie Nelson	Barbra Streisand	Jeffrey Lebowski
Sinead O'Connor	Antonio Vivaldi	Ann Coulter
Beatrix Potter	Jane Goodall	David Byrne
Sterling Archer	Xena	Dorian Gray
Bob Belcher	Liz Lemon	Edward Hopper
Walt Longmire	Sam Spade	Sarah Connor
Eleanor Rigby	Tina Turner	Bruce Wayne
Mister Magoo	Imelda Marcos	"Matt ""Daredevil"" Murdock"
Joseph McCarthy	Noam Chomsky	Hedda Hopper
Offred	Jane Austen	Atticus Finch
Hedda Hopper	Lou Reed	Bette Davis
Roseanne Barr	Lenny Bruce	Amy Schumer
Steve Guttenberg	Bing Crosby	 